##################
#S  .  .  .  .  #
#.  ########  .  #
#.  #       #  .  #
#.  #  ####  #  .  #
#.  #  .  .  #  .  #
#.  ########  .  #
#  .  .  .  .  E#
##################
